11111111
10000001
1001C001
1E01C001
11111111