11111111
10010EC1
10010001
1P010001
11111111