111111111111111111
1E01C1C1C1C10101C1
10C00C00C00000C001
101C1C1C1C1C1C1CP1
111111111111111111